"a" = (/turf/Grass,/area/Map)
"b" = (/turf/StoneWall,/area/Map)
"c" = (/turf/leaves,/area/Map)
"d" = (/turf/stonefloor,/area/Map)
"e" = (/turf/tree,/area/Map)
"f" = (/turf/Dirt,/area/Map)
"g" = (/turf/Dirt{tag = "start"},/area/Map)
"h" = (/turf/WoodWall,/area/Map)
"i" = (/turf/woodfloor,/area/Map)
"j" = (/turf/Woodendoor,/area/Map)
"k" = (/mob/ai/blue,/turf/Dirt,/area/Map)
"l" = (/turf/WoodenDoor,/area/Map)
"m" = (/mob/ai/blue,/turf/Grass,/area/Map)
"n" = (/mob/ai/red,/turf/stonefloor,/area/Map)
"o" = (/turf/StoneWall,/area)
"p" = (/mob/NPCs/pikachu,/turf/stonefloor,/area/Map)
"q" = (/mob/Throne,/turf/stonefloor,/area/Map)

(1,1,1) = {"
aaaaaaaaaaaaaaaaaaaaaaaaaaaaaaaaaaaaaaaaaaaaaaaaaaaaaaaaaaaaaaaaaaaaaaabbbbbbbbbbbbbbbbbbbbbbbbbbbbb
aaaaaacaaaaaaaaaaaaaaaaaaaaaaaaaaaaaaaaaaaaaaaaaaaaaaaaaaaaaaaaaaaaaaaabaaaaaaabdddddddddddbaaaaaaab
aaaaaaeaaaaaaaaaaaaaaaaaaaaaaaaaaaaaaaaaaaaaaaaaaaaaaaaaaaaaaaaaaaaaaaabaafgfaabdddddddddddbaafffaab
aaaaaaaaaaaaaaaaaaaaaaaaaaaaaaaaaaaaaaaaaaaaaaaaaaaaaaaaaaaaaaaaaaaaaaabaafffaabdddddddddddbaafffaab
acaaaaaaaaaaaaaaaaaaaaaaaaaaaaaaaaaaaaaaaaaaaaaaaaaaaaaaaaaaaaaaaaaaaaabaaafaaabdddddddddddbaaafaaab
aeaaaaaaaaaaaaaaaaaaaacaaaaaaaaaaaaaaaaaaacaaaaaaaaaaaaaaaaaaaaaaaaaaaabaaafaaabdddddddddddbaaafaaab
aaaaaaacaaaaaaaaaaaaaaeaaaaaaaaaaaaaaaaaaaeaaaaaaaaaaaaaaaaaaaaaaaaaaaabhhhfhhhbdddddddddddbaaafaaab
aaaaaaaeaaacaaaacaaaaaaaaaaaaaaaaacaaaaaaaaaaaaaaaaaaaaaaaaaaaaaaaaaaaabhihfhihbbbbbbjbbbbbbaaafaaab
aaacaaaaaaaeaaaaeaaaaaaaaaaaaaaaaaeaaaaaaaaaaaaaaaaaaaaaaaaaaaaaaaaaaaabhihfhihaaaaakfkaaaaaaaafaaab
aaaeaaaaaaaaaaaaaaaaaaaaaaaacaaaaaaaaaaaaaaaaaaaaaaaaaaaaaaaaaaaaaaaaaabhilflihaaaaafffaaaaaaaafaaab
aaaaaaaaaaaaaaaaaaaaaaaaaaaaeaaaaaaaaaaaaaaaaaaaaaaaaaaaaaaaaaaaaaaaaaabhhhfhhhaaaaafffaaaaaaaafaaab
aaaaaaaaaaaaaaaaaaaaaaaaaaaaaaaaaaaaaaaaaaaaacaaaaaaaaaaaaaaaaaaaaaaaaabaaafaaaaaaaaafaaaaaaaaafaaab
aaaaacaaaaacaaacaaaacaaaaaaaaaaaaaaaaaacaaaaaeaaaaaaaaaaaaaaaaaaaaaaaaabaaafaaaaaaaaafaaaaaaaaafaaab
aaaaaeaaaaaeaaaeaaaaeaaaaaaaaaaaaaaaaaaeaaaaaaaaaaaaaaaaaaaaaaaaaaaaaaabaaafaaaaaaaaafaaaaaaaaafaaab
aaaaaaaaaaaaaaaaaaaaaaaaaaaaaaaaaaaaaaaaaaaaaaaaaaaaaaaaaaaaaaaaaaaaaaabaaafffffffffffffffffffffaaab
aaaaaaaaaaaaaaaaaaaaaaaaaaaacaaaaaaaaaaaaaaaaaaaaaaaaaaaaaaaaaaaaaaaaaabaaaaaaaaaaafaaaaaaaaaaaaaaab
acaaaaaaacaaaaaaaaaaaaaaaaaaeaaaaaaaacaaaaaaaaaaaaaaaaaaaaaaaaaaaaaaaaabaaaaaaaaaaafaaaaaaaaaaaaaaab
aeaaaaaaaeaaaacaaaaaaaaaaaaaaaaaaaaaaeaaaaaaaaaaaaaaaaaaaaaaaaaaaaaaaabbbbaaaaaaaaafaaaaaaaaaaaaaaab
aaaaaaaaaaaaaaeaaaaaaaaaaaaaaaaaaaaaaaaaaaaaaaaaaaaaaaaaaaaaaaaaaaaaabbiilaaaaaaaafffaaaaaaaaaaaaaab
aaaaaacaaaaaaaaaaaaacaaaaaaaaaaaaaaaaaaaacaaaaaaaaaaaaaaaaaaaaaaaaaabbiiibbbbbbbbbfffbbbbbbbbbbbbbbb
aaaaaaeaaaaaaaaaaaaaeaaaaaaaaaaaaaaaaaaaaeaaaaaacaaaaaaaaaaaaaaaaaaabiiiiibaaaaaamfffmaaaaaaaaaaaaaa
aaaaaaaaaaaaaaaaaaaaaaaaaaaaaaaaaacaaaaaaaaaaaaaaaaaaaaaaaaaaaaaaaaabbiiibbaaaaaaafffaaaaaaaaaaaaaaa
aaacaaaaaaaaaaacaaaaaaaaacaaaaaaaaeaaaaaaaaaaaaaaaaaaaaaaaaaaaaaaaaaabbibbaaaaaaaafffaaaaaaaaaaaaaaa
aaaeaaaaaacaaaaeaaaaaaaaaeaaaaaaaaaaaaaaaaaaaaacaaaaaacaaaaaaaaaaaaaaabbbaaaaaaaaafffaaaaaaaaaaaaaaa
aaaaaaaaaaeaaaaaaaaaaaaaaaaaaaaaaaaaaaacaaaaaaaeaaaaaaeaaaaaaaaaaaaaaaaaaaaaaaaaaafffaaaaaaaaaaaaaaa
aaaaaaaaaaaaaaaaaaaaaaaaaaaaaaacaaaaaaaeaaaaaaaaaaaaaaaaaaaaaaaaaaaaaaaaaaaaaaaaaafffaaaaaaaaaaaaaaa
aaaaaaaaaaaaaaaacaaaaaaaaaaaaaaeaaaaaaaaaaaaaaaaaacaaaaaaaaaaaaaaaaaaaaaaaaaaaaaaafffaaaaaaaaaaaaaaa
acaaaaacaaaaaaaaeaaaaaaaaaaaaaaaaaaaaaaaaaacaaaaaaeaaaaaaaaaacaaaaacaaaaaaaaaaaaaafffaaaaaaaaaaaaaaa
aeaaaaaeaaaaaaaaaaaaaaaaaaaaaaaaaaaaaaaaaaaeaaaaaaaaaaaaaaaaaeaaaaaeaaaaaaaaaaaaaffffaaaaaaaaaaaaaaa
aaaaaaaaaaaaaaaaaaaaaaaaacaaaaaaaaaaacaaaaaaaaaaaaaaaaaaaaaaaaaaaaaaaaaaaacaaaaaaafffaaaaaaaaaaaaaaa
aaaaaaaaaaaacaaaaaaaaaaaaeaaaaaacaaaaeaaaaaaaaaaaaaaaaaacaaaaaaaaaaaaaacaaeaaaaaaafffaaaaaaaaaaaaaaa
aaaacaaaaaaaeaaaaaaaaaaaaaaaaaaaeaaaaaaaaaaaaaaaaaaaaaaaeaaaaaaaaaaacaaeaaaaaaaaaafffafaaaaaaaaaaaaa
aaaaeaaaaaaaaaaaaaaaaaaaaaaaaaaaaaaaaaaaaaaaaaaacaaaaaaaaaaaaaaaacaaeacaafaafaaaafffffaaaaaaaaaaaaaa
aaaaaaaaaacaaaaaaaaaaacaaaaaaaaaaaaaaaaaacaaaaaaeaaacaacaaaaaacaaeacaaeffffffffffffffaaaaaaaaaaaaaaa
aaaaaaaaaaeaaaaaaaaaaaeaaaaaaaaaaaaaaaaaaeaaaaaaaaaaeaaeaaaaaaeacaaeaaffffffffffffffffaaaaaaaaaaaaaa
aacaaaaaaaaaaaaaaaaaaaaaaaaaaaaacaaaaacaaaaacaaaaaaaaaaaaaacacaaefffffffffffffaaafaaaaaaaaaaaaaaaaaa
aaeaaaaaaaaaaaaacaaaaaaaaaacaaaaeaaaaaeaaaaaeaaaaacaaacaaaaeaeaafffffffffkaafaaaaaaaaaaaaaaaaaaaaaaa
aaaaaacaaaaacaaaeaaaacaaaaaeaaaaaaaaaaaaaaaaaaaaaaeaaaeaacaaakffffffffcaaacaaaaaaaaaaaaaaaaaaaaaaaaa
aaaaaaeaaaaaeaaaaaaaaeaaacaaaaaaaaaacaaaaaaaacaaaaaaaaaaaeacafffffcffaeaaaeaaaaaaaaaaaaaaaaaaaaaaaaa
aaaaaaaaacaaaaaaaaaaaaaaaeaaaaaaaaaaeaaaacaaaeaaaaaaaacacaaeffffcaeaaaaaaaaaaaaaaaaaaaaaaaaaaaaaaaaa
aaaaaaaaaeaaaaaaaaaaaaaaaaaaaaacaaaaaaaaaeaaaaaaaacacaeaefffffffeaaaacaaaaaaaaaaaaaacaaaaaaaaaaaaaaa
aaaaaaaaaaaaacaaaaacaaacaaaaaaaeaaaaaaaaaaaacaaacaeaeaaffffffffcaaaaaeaaaaaaaaaaaaaaeaaaaaaaaaaaaaaa
aaacaaaaaaaaaeaaaaaeaaaeaaaacaaaaaaaaaaaaaaaeaaaeaaaaafffffffaceaaaaaaaaaaaaaaaaaaaaaaaaaaaacaaaaaaa
aaaeaaacaaaaaaaaacaaaaaaaaaaeaaaaaaaaacaaaaaaaacacacffffffaaaaeaaaaaaaaaaaaaaacaaaaaaaaaaaaaeaaaaaaa
aaaaaaaeaaaacaaaaeaaaaaaaaaaaaaaaaacaaeaaaaacaaeaeaefffffaaaaaaaaaaaaaaaaaaaaaeaaaaaaaaaaaaaaaaaaaaa
aaaaaaaaaaaaeaaaaaaaaaaacaaaaaaaaaaeaaaaaaaaeaaaafffffffaaacaaaaaaaaaaaacaaaaaaaaaaaaaaaaaaaaaaaaaaa
aaaaaaacaaaaaaaacaaaaaaaeaaaaaaaaaaaaaaaaaacacaafffffffaacaeaaacaaaaaaaaeaaaaaaaaaaaaacaaaaaaaaaaaaa
aaaaaaaeaaaaaaaaeaaaaaaaaaaaaaaacaaaaaaaaaaeaeafffffffacaeaaaaaeaaaaaaaaaaaaaaaaaaaaaaeaaaaaaaaaacaa
aaaaaaaaaaaaaaaaaaaacaaaaaaaacaaeaaacaaaaacaaaffffaaaaaeaaaaaaaaaaaaaaaaaaaaaaaaaaaaaaaaaaaaaaaaaeaa
aaaaaaaaaaaaaaacaaaaeaaaaaaaaeaaaaaaeaaacaeaafffffaacaaacaaaaaaaaaaaacaaaaaaaaaacaaaaaaaaaaaaaaaaaaa
aacaaacaacaaaaaeaaaaaaaaaaaaaaaaaaaaaaaaeaaafffffaaaeaaaeaaaaaaaaaaaaeaaaaaaaaaaeaaaaaaaaaaaaaaaaaaa
aaeaaaeaaeaaaaaaaaaaaaaaaaaaaaaaaaaaaacaaaafffffaacaaaaaaaaaaaaaaaaaaaaaaaaaaaaaaaaaaaaacaaaaaaaaaaa
aaaaaaaaaaaacaaaaaaaaaaaacaaaaaaaaaaaaeacafffffaaaeaaacaaaaaaaaaacaaaaaaaaaaaaaaaaaaaaaaeaaaaaaaaaaa
aaaaaaaaaaaaeaaaaaaacaaaaeaaaaaaaaaacaaaefffffaacaacaaeaaaaaacaaaeaaaaaaaacaaaaaaaaaaaaaaaaaaacaaaaa
aaaaaaaaacaaaaaaaaaaeaaaaaaaaaaaacaaeacafffffacaeaaeaaaaaaaaaeaaaaacaaaaaaeaaaaaaaaaaaaaaaaaaaeaaaaa
aaaaacaaaeaaaacaaaaaaaaaaaaaaaaaaeaaaaefffffaaeaacaaacaaaaaaaaaaaaaeaaaaaaaaaaaaaaacaaaaaaaaaaaaaaaa
aaaaaeaaaaaaaaeaaacaaaaaaaaaacaaaaacaafffffacaacaeaaaeaaaaaaaaaaaaaaaaaaaaaaaaaaaaaeaaaaaaaaaaaaaaaa
aaaaaaaaaaaaaaaaaaeaaaaaaaaaaeaaacaeafffffaaecaeaaaaaaaaaaaaaaaaaaaaaaaaaaaaaaaaaaaaaaaaaaaaaaaaaaaa
aacaaaaaaaaaaaaaaaaaaaaaaaaacaacaeaffffffaacaeaaaaaaaaacaaaaaaaaaaaaaaacaaaaaaaaaaaaaaaaaaaaaaaaaaaa
aaeaaacaaaacaaaaaaaaaaccacaaeaaeaaffffffaaaeacaaaaaaaaaeaaaaaaaaaaaaaaaeaaaaaacaaaaaaaaaaaaaaaaaaaaa
aaaaaaeaaaaeaaaacaacaceeceaaffffffffffaaacacaeaaaaaaaaaaaaaaaaaaaaaaaaaaaaaaaaeaaaaaaaaaaaaaaaaaaaaa
aaaaaaaaaaaaaaaaeaaeaeaaeaaffffffffffacaaeaeaaaaacaaaaaacaaaaaaacaaacaaaaaaaaaaaaaaaaaaaacaaaaaaaaaa
aaaaaaaaaaaaaaaaacaafffffffffffaaaacaaeaaaaaaaaaaeaaaaaaeaaaaaaaeaaaeaaaaaaaaaaaaaaaaaaaaeaaaaacaaaa
aaaaaaaaaaaaaaaaceafffffffffffaacaaeacaacaaaaaaaaaaaaaaaaaaaaaacaaaaaaaaaaaaacaaaaaaaaaaaaaaaaaeaaaa
aaaaaaaaaaaaaaaaeffffffaaaaaaaacecaaaecaeaaaaaaaaaaaaaaaaaaaaaaeaaaaaaaaaaaaaeaaaaaaaaaaaaaaaaaaaaaa
aaaaaaaaaaaaaaaaffffffacaacaacaeaeacaaeaaaaaaaaaaaaaaaaaaaaaaaaaaaaaaaaaaaaaaaaaaaaaaaacaaaaaaaaaaaa
aaaaaaaaaaaaaaafffffaaaeaaeaaeaaaaaeaaaaaaaaaaaaaaaaaaaaaaaaaaaaaaaaaaaaaaaaaaaaaaaaaaaeaaaaaaaaaaaa
aaaaaaaaaaaaaafffffaaaaaaaaacaaaaaaaaaaaaaaaacaaaaaaaaaaaaaaaaaaaaaacaaaaaaaaaaaaaaaaaaaaaaaaaaaaaaa
aaaaaaaaaaaaaffffaaaaaaaaacaeaaaacaaaaaaaaaaaeaaaaaacaaaacaaaaaaaaaaeaaaaaaaaaaaaaaaaaaaaaaaaaaaaaaa
aaaaaaaaaaaaafffaaaaaaaaaaeaaaaaaeaaaaaaaaaaaaaaaaaaeaaaaeaaaaaaaaaaaaaaaaaaaaaaaaaaaaaaaaaaaaaaaaaa
aaaaaaaaaaaafffaaaaaaaaaaaaaaaaaaaaaaaaaaaaaaaaaaaaaaaaaaaaaaaaaaaaaaaaaaaaaaaaaaaaaacaaaaaaaaaaaaaa
aaaaaaaaaaaafffaaaaaaaaaaaaaaaaaaaaaaaaaaaaaaaaaaaacaaaaaaaaaaaaaaaaaaaaaaaaacaaaaaaaeaaaaaaaacaaaaa
aaaaaaaaaaaaffaaaaaaaaaaaaaaaaaaaaaaaaaaaacaaaaaaaaeaaaaaaaaaaaaaaaaaaaaaaaaaeaaaaaaaaaaaaaaaaeaaaaa
aaaaaaaaaaaaffaaaaaaaaaaaaaaaaaaaaaaaaaaaaeaaaaaaaaaaaaaaaaaaaaaaacaaaaaaaaaaaaaaaaacaaaaaaaaaaaaaaa
aaaaaaaaaaaaffaaaaaaaaaaaaaaaaaaaaaaaaaaaaaaaaaaaaaaaaaaaaaaaaaaaaeaaaaaaaaaaaaaaaaaeaaaaaaaaaaaaaaa
aaaaaaaaaaaaffaaaaaaaaaaaaaaaaaaaaaaaaaaaaaaaaaaaaaaaaaaacaaaaacaaaaaaaacaaaaaaaaaaaaaaaaaaaaaaaaaaa
aaaaaaaaaaaaffaaaaaaaaaaaaaaaaaaaaaaaaaaaaaaaaaaaaaaaaaaaeaaaaaeaaaaaaaaeaaaaaaaaaaaaaaaaaaaaacaaaaa
aaaaaaaaaaaaffaaaaaaaaaaaaaaaaaaaaaaaaaaaaaaaaaaaaaaacaaaaaaaaaaaaaaaaaaaaaaaaaaaaaaaaaaaaaaaaeaaaaa
aaaaaaaaaaaddddaaaaaaaaaaaaaaaaaaaaaaaaaaaaaaaaaaaaaaeaaaaaaaaaaaaaaaacaaaaaaaaaaacaaaaaacaaaaaaaaaa
aaaaaaaaaaaddddaaaaaaaaaaaaaaaaaaaaaaaaaaaaaaaaaaaaaaaaaaaaaaaaaaaaaaaeaaaaaaaaaaaeaaaaaaeaaaaaaaaaa
bbbbbbbbbbbbjjbbbbbbbbbbbbaaaaaaaaaaaaaaaaaaaaaaaaaaaaaaaaaaaaacaaaaaaaaaaacaaaaaaaaaaaaaaaaaaaaaaaa
bddddddddddddddddddddddddbaaaaaaaaaaaaaaaaaaaaaaaaaaaaaacaaaaaaeaaaaaaaaaaaeaaaaaaaaaaaaaaaaaaaaaaaa
bddddddddddddddddddddddddbaaaaaaaaaaaaaaaaaaaaaaaaaaaaaaeaaaaaaaaaaaaaaaaaaaaaaaaaaaaaaaaaaaaaaaaaaa
bddddddddddndddddddddddddbaaaaaaaaaaaaaaaaaaaaaaaaaaaaaaaaaaaaaaaaacaaaaaaaaaaaaaaaaaaaaaaaaaaaaaaaa
bddddddddddddddddddddddddbaaaaaaaaaaaaaaaaaaaaaaaaaaaaaaaaaaaaaaaaaeaaaaaaaaaaaaaaaaaaaaaaaaaaaaaaaa
bddddddddddddddddddddddddbaaaaaaaaaaaaaaaaaaaaaaaaaaacaaaaaaaaaaaaaaaaaaaaaaaaaacaaaaacaaaaaaaaaaaaa
bdddddddddndddddnddddddddbaaaaaaaaaaaaaaaaaaaaaaacaaaeaaaacaaaaacaaaaaaaaacaaaaaeaaaaaeaaaaaacaaaaaa
bddddddddddddddddddddddddbaaaaaaaaaaaaaaaaaaaaaaaeaaaaaaaaeaaaaaeaaaaaaaaaeaaaaaaaaaaaaaaaaaaeaaaaaa
bobbbbddbbbbbjbbbbbddbbbbbaaaaaaaaaaaaaaaaaaaaaaaaaaaaaaaaaaaaaaaaaaaaacaaaaaaaaaaaaaaaaaaaaaaaaaaaa
bddddbddbdddbdbdddbddbdddbaaaaaaaaaaaaaaaaaaaaaaaacaaaaaaaaaaaaaaaaaaaaeaaaaaaaaaaaaaaaaaaaaaaaaaaaa
bddddbddbdddbdbdddbddbdddbaaaaaaaaaaaaaaaaaaaaaaaaeaacaaaaaaaaaaaaaaaaaaaaaaaaaaaaaaaaaaaaaaaaaaaaaa
bddddjddjdddbdbdddjddjdddbaaaaaaaaaaaaaaaaaaaaaaaaaaaeaaaaaaaaaaaacaaaaaaaaaaaaaaaaaacaaaaaaaaaaaaaa
bddddbddbdddbdbdddbddbdddbaaaaaaaaaaaaaaaaaaaaaaaaaaaaaaaaaaaaaaaaeaaaaaaaacaaaaaaaaaeaaaaaaaaaaaaaa
bddddbddbdddbdbdddbddbdddbaaaaaaaaaaaaaaaaaaaaaaaaaaaaaaaaaaaaaaaaaaaaaaaaaeaaaaaaaaaaaaaaaaaaaaaaaa
bbbbbbddbbbbbjbbbbbddbbbbbaaaaaaaaaaaaaaaaaaaaaaaaaaaaaaaacaaaaaaaaaaaacaaaaaaaaacaaaaaaaaaaaaaaaaaa
bdddpbddbdddddddddbddbdddbaaaaaaaaaaaaaaaaaaaaaaaaaaaaaaaaeaaaaaaaaaaaaeaaaaaaaaaeaaaaaaaaaaaaaaaaaa
bddddjddbdddddddddbddjdddbaaaaaaaaaaaaaaaaaaaaaaaacaaaaaaaaaaaaaaaaaaaaaaaaaaaaaaaaaaaaaaacaaaaaaaaa
bddddbddbdddddddddbddbdddbaaaaaaaaaaaaaaaaaaaaaaaaeaacaaaaaaaaaaaaacaaaaaaaaaaaaaaaaaaaaaaeaaaaaaaaa
bddddbddbddddqddddbddbdddbaaaaaaaaaaaaaaaaaaaaaaaaaaaeaaaaaaaaaaaaaeaaaaaaaaaaaaaaaaaaaaaaaaaaaaaaaa
bbbbbbbbbbbbbbbbbbbbbbbbbbaaaaaaaaaaaaaaaaaaaaaaaaaaaaaaaaaaaaaaaaaaaaaaaaaaaaaaaaaaaaaaaaaaaaaaaaaa
"}
